####################
#        H         #
# #### ########### #
#                  #
# # ####### # # #  #
#   #         #    #
# ### ####### # #  #
#  G            G  #
####################