##########
#   H    #
# ## ### #
# ##   # #
# #### ###
#        #
# # # ## #
# # #  # #
#   ## G #
##########