########################
#   ##   #      G      #
# #  # # # ########### #
# ## # # #   #   #   # #
# G      # # # # # # #H#
########   #   #   #   #
########################